Anderson County = Clinton, Norris, Oak Ridge, Oliver Springs, Rocky Top
Bedford County = Bell Buckle, Normandy, Shelbyville, Wartrace
Benton County = Big Sandy, Camden
Bledsoe County = Pikeville
Blount County = Alcoa, Friendsville, Louisville, Maryville, Rockford, Townsend
Bradley County = Charleston, Cleveland
Campbell County = Caryville, Jacksboro, Jellico, LaFollette, Rocky Top
Cannon County = Auburntown, Woodbury
Carroll County = Atwood, Bruceton, Clarksburg, Hollow Rock, Huntingdon, McKenzie, McLemoresville, Trezevant
Carter County = Elizabethton, Johnson City, Watauga
Cheatham County = Ashland City, Kingston Springs, Pegram, Pleasant View
Chester County = Enville, Henderson, Milledgeville, Silerton
Claiborne County = Cumberland Gap, Harrogate, New Tazewell, Tazewell
Clay County = Celina
Cocke County = Newport, Parrottsville
Coffee County = Manchester, Tullahoma
Crockett County = Alamo, Bells, Friendship, Gadsden, Maury City
Cumberland County = Crab Orchard, Crossville, Pleasant Hill
Davidson County = Belle Meade, Berry Hill, Forest Hills, Goodlettsville, Nashville, Oak Hill, Ridgetop
DeKalb County = Alexandria, Dowelltown, Liberty, Smithville
Decatur County = Decaturville, Parsons, Scotts Hill
Dickson County = Burns, Charlotte, Dickson, Slayden, Vanleer, White Bluff
Dyer County = Dyersburg, Newbern, Trimble
Fayette County = Braden, Gallaway, Grand Junction, La Grange, Moscow, Oakland, Piperton, Rossville, Somerville, Williston
Fentress County = Allardt, Jamestown
Franklin County = Cowan, Decherd, Estill Springs, Huntland, Tullahoma, Winchester
Gibson County = Bradford, Dyer, Gibson, Humboldt, Kenton, Medina, Milan, Rutherford, Trenton, Yorkville
Giles County = Ardmore, Elkton, Lynnville, Minor Hill, Pulaski
Grainger County = Bean Station, Blaine, Rutledge
Greene County = Baileyton, Greeneville, Mosheim, Tusculum
Grundy County = Altamont, Beersheba Springs, Coalmont, Gruetli-Laager, Monteagle, Palmer, Tracy City
Hamblen County = Morristown
Hamilton County = Chattanooga, Collegedale, East Ridge, Lakesite, Lookout Mountain, Red Bank, Ridgeside, Signal Mountain, Soddy-Daisy, Walden
Hancock County = Sneedville
Hardeman County = Bolivar, Grand Junction, Hickory Valley, Hornsby, Middleton, Saulsbury, Silerton, Toone, Whiteville
Hardin County = Adamsville, Crump, Milledgeville, Saltillo, Savannah
Hawkins County = Bulls Gap, Church Hill, Kingsport, Mount Carmel, Rogersville, Surgoinsville
Haywood County = Brownsville, Stanton
Henderson County = Lexington, Parker's Crossroads, Sardis, Scotts Hill
Henry County = Cottage Grove, Henry, McKenzie, Paris, Puryear
Hickman County = Centerville
Houston County = Erin, Tennessee Ridge
Humphreys County = McEwen, New Johnsonville, Waverly
Jackson County = Gainesboro
Jefferson County = Baneberry, Dandridge, Jefferson City, New Market, White Pine
Johnson County = Mountain City
Knox County = Farragut, Knoxville
Lake County = Ridgely, Tiptonville
Lauderdale County = Gates, Halls, Henning, Ripley
Lawrence County = Ethridge, Lawrenceburg, Loretto, St. Joseph
Lewis County = Hohenwald
Lincoln County = Fayetteville, Petersburg
Loudon County = Greenback, Lenoir City, Loudon, Philadelphia
Macon County = Lafayette, Red Boiling Springs
Madison County = Jackson, Medon, Three Way
Marion County = Jasper, Kimball, Monteagle, New Hope, Orme, Powell's Crossroads, South Pittsburg, Whitwell
Marshall County = Chapel Hill, Cornersville, Lewisburg, Petersburg
Maury County = Columbia, Mount Pleasant, Spring Hill
McMinn County = Athens, Calhoun, Englewood, Etowah, Niota, Sweetwater
McNairy County = Adamsville, Bethel Springs, Eastview, Enville, Finger, Guys, Michie, Milledgeville, Ramer, Selmer, Stantonville
Meigs County = Decatur
Monroe County = Madisonville, Sweetwater, Tellico Plains, Vonore
Montgomery County = Clarksville
Moore County = Lynchburg
Morgan County = Oakdale, Oliver Springs, Sunbright, Wartburg
Obion County = Hornbeak, Kenton, Obion, Rives, Samburg, South Fulton, Trimble, Troy, Union City, Woodland Mills
Overton County = Livingston
Perry County = Linden, Lobelville
Pickett County = Byrdstown
Polk County = Benton, Copperhill, Ducktown
Putnam County = Algood, Baxter, Cookeville, Monterey
Rhea County = Dayton, Graysville, Spring City
Roane County = Harriman, Kingston, Oak Ridge, Oliver Springs, Rockwood
Robertson County = Adams, Cedar Hill, Coopertown, Cross Plains, Greenbrier, Millersville, Orlinda, Ridgetop, Springfield, White House
Rutherford County = Eagleville, La Vergne, Murfreesboro, Smyrna
Scott County = Huntsville, Oneida, Winfield
Sequatchie County = Dunlap
Sevier County = Gatlinburg, Pigeon Forge, Pittman Center, Sevierville
Shelby County = Arlington, Bartlett, Collierville, Germantown, Lakeland, Memphis, Millington
Smith County = Carthage, Gordonsville, South Carthage
Stewart County = Cumberland City, Dover, Tennessee Ridge
Sullivan County = Bluff City, Bristol, Johnson City, Kingsport
Sumner County = Gallatin, Goodlettsville, Hendersonville, Millersville, Mitchellville, Portland, Westmoreland, White House
Tipton County = Atoka, Brighton, Burlison, Covington, Garland, Gilt Edge, Mason, Munford
Trousdale County = Hartsville
Unicoi County = Erwin, Unicoi
Union County = Luttrell, Maynardville, Plainview
Van Buren County = Spencer
Warren County = Centertown, McMinnville, Morrison, Viola
Washington County = Johnson City, Jonesborough
Wayne County = Clifton, Collinwood, Waynesboro
Weakley County = Dresden, Gleason, Greenfield, Martin, McKenzie, Sharon
White County = Doyle, Sparta
Williamson County = Brentwood, Fairview, Franklin, Nolensville, Spring Hill, Thompson's Station
Wilson County = Lebanon, Mount Juliet, Watertown
